//MAP CONVERTED BY dmm2tgm.py THIS HEADER COMMENT PREVENTS RECONVERSION, DO NOT REMOVE
"am" = (
/obj/structure/stone_tile/slab/cracked,
/obj/effect/mob_spawn/corpse/human/clown,
/turf/open/misc/basalt/safe/arena,
/area/centcom/tdome/arena/actual)
"ax" = (
/obj/effect/decal/cleanable/blood,
/turf/open/floor/cult,
/area/centcom/tdome/arena/actual)
"bk" = (
/obj/structure/destructible/cult/item_dispenser/altar,
/obj/item/toy/plush/narplush,
/turf/open/floor/cult,
/area/centcom/tdome/arena/actual)
"bw" = (
/turf/open/floor/cult,
/area/centcom/tdome/arena/actual)
"bK" = (
/obj/structure/stone_tile/slab,
/obj/machinery/light/floor/has_bulb,
/turf/open/misc/basalt/safe/arena,
/area/centcom/tdome/arena/actual)
"bU" = (
/obj/machinery/light/floor/has_bulb,
/turf/open/floor/cult,
/area/centcom/tdome/arena/actual)
"cx" = (
/obj/structure/stone_tile/slab,
/obj/item/melee/cultblade/dagger,
/turf/open/misc/basalt/safe/arena,
/area/centcom/tdome/arena/actual)
"df" = (
/obj/effect/decal/cleanable/blood/drip{
	icon_state = "floor5"
	},
/obj/structure/railing{
	color = "#8E5450"
	},
/turf/open/floor/cult,
/area/centcom/tdome/arena/actual)
"dJ" = (
/obj/effect/mob_spawn/corpse/human/doctor,
/turf/open/floor/cult,
/area/centcom/tdome/arena/actual)
"dK" = (
/turf/open/lava,
/area/centcom/tdome/arena/actual)
"el" = (
/obj/structure/destructible/cult/item_dispenser/forge,
/turf/open/floor/cult,
/area/centcom/tdome/arena/actual)
"em" = (
/obj/structure/stone_tile/cracked{
	dir = 4
	},
/obj/structure/stone_tile/burnt{
	dir = 1
	},
/turf/open/lava,
/area/centcom/tdome/arena/actual)
"fs" = (
/obj/structure/stone_tile/burnt,
/obj/structure/stone_tile/cracked{
	dir = 1
	},
/turf/open/lava,
/area/centcom/tdome/arena/actual)
"fx" = (
/obj/effect/decal/cleanable/blood/tracks{
	dir = 8
	},
/turf/open/floor/cult,
/area/centcom/tdome/arena/actual)
"fS" = (
/obj/effect/decal/cleanable/blood,
/obj/structure/railing{
	dir = 8;
	color = "#8E5450"
	},
/turf/open/floor/cult,
/area/centcom/tdome/arena/actual)
"hG" = (
/obj/structure/stone_tile/cracked{
	dir = 1
	},
/obj/structure/railing{
	color = "#8E5450"
	},
/turf/open/misc/basalt/safe/arena,
/area/centcom/tdome/arena/actual)
"if" = (
/obj/effect/decal/cleanable/blood/tracks{
	dir = 8
	},
/obj/structure/railing{
	dir = 1;
	color = "#8E5450"
	},
/turf/open/floor/cult,
/area/centcom/tdome/arena/actual)
"jw" = (
/obj/effect/decal/cleanable/blood/drip{
	icon_state = "drip2"
	},
/obj/structure/railing{
	color = "#8E5450"
	},
/turf/open/floor/cult,
/area/centcom/tdome/arena/actual)
"kX" = (
/obj/effect/decal/cleanable/blood/splatter,
/obj/structure/railing{
	dir = 1;
	color = "#8E5450"
	},
/turf/open/floor/cult,
/area/centcom/tdome/arena/actual)
"lb" = (
/obj/structure/stone_tile/burnt{
	dir = 4
	},
/obj/structure/railing{
	dir = 1;
	color = "#8E5450"
	},
/turf/open/misc/basalt/safe/arena,
/area/centcom/tdome/arena/actual)
"lo" = (
/obj/effect/rune/blood_boil,
/turf/open/floor/cult,
/area/centcom/tdome/arena/actual)
"lY" = (
/obj/effect/decal/cleanable/blood,
/obj/machinery/light/floor/has_bulb,
/turf/open/floor/cult,
/area/centcom/tdome/arena/actual)
"mc" = (
/obj/effect/decal/cleanable/blood/drip,
/obj/structure/railing{
	dir = 1;
	color = "#8E5450"
	},
/turf/open/floor/cult,
/area/centcom/tdome/arena/actual)
"mw" = (
/obj/effect/decal/cleanable/blood/drip{
	icon_state = "floor3"
	},
/turf/open/floor/cult,
/area/centcom/tdome/arena/actual)
"my" = (
/obj/structure/railing{
	dir = 1;
	color = "#8E5450"
	},
/turf/open/floor/cult,
/area/centcom/tdome/arena/actual)
"mV" = (
/obj/effect/rune/empower,
/turf/open/floor/cult,
/area/centcom/tdome/arena/actual)
"oj" = (
/obj/effect/mob_spawn/corpse/human/assistant,
/turf/open/floor/cult,
/area/centcom/tdome/arena/actual)
"pP" = (
/obj/effect/decal/cleanable/blood/tracks{
	dir = 1
	},
/turf/open/floor/cult,
/area/centcom/tdome/arena/actual)
"vm" = (
/obj/structure/stone_tile/block/cracked{
	dir = 1
	},
/turf/open/lava,
/area/centcom/tdome/arena/actual)
"vo" = (
/obj/effect/decal/cleanable/blood/drip,
/turf/open/floor/cult,
/area/centcom/tdome/arena/actual)
"xd" = (
/obj/effect/rune/teleport,
/turf/open/floor/cult,
/area/centcom/tdome/arena/actual)
"xe" = (
/obj/structure/stone_tile/block{
	dir = 1
	},
/turf/open/lava,
/area/centcom/tdome/arena/actual)
"xg" = (
/obj/structure/stone_tile/block{
	dir = 4
	},
/turf/open/lava,
/area/centcom/tdome/arena/actual)
"xr" = (
/obj/structure/stone_tile/block/burnt{
	dir = 4
	},
/obj/structure/railing{
	dir = 1;
	color = "#8E5450"
	},
/turf/open/misc/basalt/safe/arena,
/area/centcom/tdome/arena/actual)
"xt" = (
/obj/effect/mob_spawn/corpse/human/cargo_tech,
/turf/open/floor/cult,
/area/centcom/tdome/arena/actual)
"ya" = (
/obj/structure/stone_tile/block/cracked{
	dir = 8
	},
/turf/open/lava,
/area/centcom/tdome/arena/actual)
"yj" = (
/obj/effect/decal/cleanable/blood/tracks{
	dir = 6
	},
/obj/structure/railing{
	color = "#8E5450"
	},
/turf/open/floor/cult,
/area/centcom/tdome/arena/actual)
"yG" = (
/obj/structure/stone_tile/cracked{
	dir = 8
	},
/obj/structure/stone_tile/burnt{
	dir = 4
	},
/turf/open/lava,
/area/centcom/tdome/arena/actual)
"AO" = (
/obj/effect/decal/cleanable/blood/drip{
	icon_state = "drip2"
	},
/turf/open/floor/cult,
/area/centcom/tdome/arena/actual)
"AU" = (
/obj/effect/decal/cleanable/blood/tracks{
	dir = 5
	},
/obj/structure/railing{
	dir = 1;
	color = "#8E5450"
	},
/turf/open/floor/cult,
/area/centcom/tdome/arena/actual)
"Bc" = (
/obj/effect/decal/cleanable/blood/splatter,
/obj/structure/railing{
	dir = 8;
	color = "#8E5450"
	},
/turf/open/floor/cult,
/area/centcom/tdome/arena/actual)
"Bh" = (
/obj/structure/railing{
	dir = 4;
	color = "#8E5450"
	},
/turf/open/floor/cult,
/area/centcom/tdome/arena/actual)
"BB" = (
/obj/structure/stone_tile/block/cracked,
/turf/open/lava,
/area/centcom/tdome/arena/actual)
"CH" = (
/obj/structure/stone_tile/slab/cracked,
/obj/structure/railing{
	dir = 1;
	color = "#8E5450"
	},
/turf/open/misc/basalt/safe/arena,
/area/centcom/tdome/arena/actual)
"EG" = (
/obj/effect/rune/manifest,
/obj/structure/stone_tile/slab,
/mob/living/basic/pet/dog/corgi/narsie,
/obj/machinery/camera/motion/thunderdome{
	pixel_x = 10
	},
/turf/open/misc/basalt/safe/arena,
/area/centcom/tdome/arena/actual)
"EO" = (
/obj/effect/decal/cleanable/blood,
/obj/effect/decal/cleanable/blood/gibs,
/obj/structure/railing{
	color = "#8E5450"
	},
/turf/open/floor/cult,
/area/centcom/tdome/arena/actual)
"Gc" = (
/obj/effect/decal/cleanable/blood,
/obj/effect/decal/cleanable/blood/gibs,
/turf/open/floor/cult,
/area/centcom/tdome/arena/actual)
"Gr" = (
/obj/effect/decal/cleanable/blood,
/obj/effect/mob_spawn/corpse/human/engineer,
/obj/effect/rune/raise_dead,
/turf/open/floor/cult,
/area/centcom/tdome/arena/actual)
"GZ" = (
/obj/structure/railing{
	color = "#8E5450"
	},
/turf/open/floor/cult,
/area/centcom/tdome/arena/actual)
"HB" = (
/obj/structure/stone_tile/block/cracked{
	dir = 8
	},
/obj/structure/railing{
	color = "#8E5450"
	},
/turf/open/misc/basalt/safe/arena,
/area/centcom/tdome/arena/actual)
"KC" = (
/obj/structure/fluff/drake_statue,
/obj/structure/stone_tile/slab,
/turf/open/misc/basalt/safe/arena,
/area/centcom/tdome/arena/actual)
"LI" = (
/obj/effect/decal/cleanable/blood/tracks{
	dir = 5
	},
/obj/structure/railing{
	dir = 4;
	color = "#8E5450"
	},
/turf/open/floor/cult,
/area/centcom/tdome/arena/actual)
"Mi" = (
/obj/structure/railing{
	dir = 8;
	color = "#8E5450"
	},
/turf/open/floor/cult,
/area/centcom/tdome/arena/actual)
"Mn" = (
/obj/effect/mob_spawn/corpse/human/cook,
/obj/effect/decal/cleanable/blood,
/turf/open/floor/cult,
/area/centcom/tdome/arena/actual)
"Mr" = (
/obj/effect/decal/cleanable/blood/splatter,
/obj/structure/railing{
	color = "#8E5450"
	},
/turf/open/floor/cult,
/area/centcom/tdome/arena/actual)
"NP" = (
/obj/structure/stone_tile/cracked,
/obj/structure/stone_tile/burnt{
	dir = 8
	},
/turf/open/lava,
/area/centcom/tdome/arena/actual)
"NS" = (
/obj/effect/rune/convert,
/turf/open/floor/cult,
/area/centcom/tdome/arena/actual)
"NT" = (
/obj/structure/stone_tile/slab,
/obj/structure/railing{
	color = "#8E5450"
	},
/turf/open/misc/basalt/safe/arena,
/area/centcom/tdome/arena/actual)
"Py" = (
/obj/effect/decal/cleanable/blood/tracks{
	dir = 8
	},
/obj/machinery/light/floor/has_bulb,
/turf/open/floor/cult,
/area/centcom/tdome/arena/actual)
"PI" = (
/obj/effect/decal/cleanable/blood,
/obj/effect/decal/cleanable/blood/gibs,
/obj/structure/railing{
	dir = 1;
	color = "#8E5450"
	},
/turf/open/floor/cult,
/area/centcom/tdome/arena/actual)
"QM" = (
/obj/effect/decal/cleanable/blood/drip{
	icon_state = "floor3"
	},
/obj/structure/railing{
	dir = 1;
	color = "#8E5450"
	},
/turf/open/floor/cult,
/area/centcom/tdome/arena/actual)
"Sr" = (
/obj/structure/stone_tile/block/burnt{
	dir = 1
	},
/turf/open/lava,
/area/centcom/tdome/arena/actual)
"Ss" = (
/obj/effect/decal/cleanable/blood/splatter,
/turf/open/floor/cult,
/area/centcom/tdome/arena/actual)
"TH" = (
/obj/effect/decal/cleanable/blood/tracks{
	dir = 10
	},
/obj/machinery/light/floor/has_bulb,
/turf/open/floor/cult,
/area/centcom/tdome/arena/actual)
"TV" = (
/obj/effect/decal/cleanable/blood/drip{
	icon_state = "drip4"
	},
/obj/machinery/light/floor/has_bulb,
/obj/structure/railing{
	dir = 4;
	color = "#8E5450"
	},
/turf/open/floor/cult,
/area/centcom/tdome/arena/actual)
"Uc" = (
/obj/structure/stone_tile{
	dir = 8
	},
/obj/structure/stone_tile/cracked,
/turf/open/lava,
/area/centcom/tdome/arena/actual)
"Ux" = (
/obj/effect/decal/cleanable/blood/tracks{
	dir = 8
	},
/obj/structure/railing{
	color = "#8E5450"
	},
/turf/open/floor/cult,
/area/centcom/tdome/arena/actual)
"Vs" = (
/obj/structure/stone_tile/slab/cracked,
/obj/structure/railing{
	color = "#8E5450"
	},
/turf/open/misc/basalt/safe/arena,
/area/centcom/tdome/arena/actual)
"Wf" = (
/obj/structure/stone_tile/slab/cracked,
/obj/machinery/light/floor/has_bulb,
/turf/open/misc/basalt/safe/arena,
/area/centcom/tdome/arena/actual)
"Wt" = (
/obj/effect/decal/cleanable/blood/drip{
	icon_state = "drip1"
	},
/turf/open/floor/cult,
/area/centcom/tdome/arena/actual)
"XM" = (
/obj/structure/destructible/cult/item_dispenser/archives,
/turf/open/floor/cult,
/area/centcom/tdome/arena/actual)
"Yn" = (
/obj/structure/stone_tile/slab,
/obj/structure/railing{
	dir = 1;
	color = "#8E5450"
	},
/turf/open/misc/basalt/safe/arena,
/area/centcom/tdome/arena/actual)
"YN" = (
/obj/effect/rune/manifest,
/turf/open/floor/cult,
/area/centcom/tdome/arena/actual)
"Zb" = (
/obj/effect/decal/cleanable/blood/splatter,
/obj/effect/mob_spawn/corpse/human/bartender,
/turf/open/floor/cult,
/area/centcom/tdome/arena/actual)

(1,1,1) = {"
bw
bw
GZ
vm
CH
NT
Uc
my
ax
bw
"}
(2,1,1) = {"
Bh
bw
GZ
dK
xr
hG
dK
my
bw
Bh
"}
(3,1,1) = {"
dK
my
lY
Bc
bw
bw
Mi
bU
Mr
dK
"}
(4,1,1) = {"
dK
mc
fx
oj
bw
YN
ax
bw
jw
dK
"}
(5,1,1) = {"
dK
QM
fx
vo
Gc
bw
lo
Zb
df
dK
"}
(6,1,1) = {"
dK
my
Py
Bh
Bh
Bh
Bh
Py
GZ
dK
"}
(7,1,1) = {"
Mi
Ss
Ux
dK
yG
ya
dK
if
bw
Mi
"}
(8,1,1) = {"
XM
mV
Ux
xe
bK
am
Uc
if
bw
Ss
"}
(9,1,1) = {"
bk
Gr
yj
em
KC
EG
BB
AU
pP
ax
"}
(10,1,1) = {"
el
NS
GZ
vm
Wf
cx
NP
kX
xt
vo
"}
(11,1,1) = {"
Bh
AO
GZ
dK
xg
fs
dK
my
bw
Bh
"}
(12,1,1) = {"
dK
PI
bU
Mi
Mi
Mi
fS
bU
GZ
dK
"}
(13,1,1) = {"
dK
my
dJ
bw
mw
Wt
bw
bw
EO
dK
"}
(14,1,1) = {"
dK
my
bw
ax
xd
Ss
Mn
bw
GZ
dK
"}
(15,1,1) = {"
dK
kX
bU
TV
bw
bw
LI
TH
GZ
dK
"}
(16,1,1) = {"
Mi
bw
GZ
dK
lb
HB
dK
if
bw
Mi
"}
(17,1,1) = {"
bw
ax
GZ
Sr
Yn
Vs
BB
if
Ss
bw
"}
